{
  "name": "level1",
  "music": "level1_theme.mp3",
  "sky_texture": "sky.png",
  "sky_offset": 0,
  "floor_color": {
    "R": 30,
    "G": 30,
    "B": 30
  },
  "floor_texture": null,
  "minimap": [
    [1, 1, 1, 1, 1, 1, 1, 1, 1, 1, 1, 1, 1, 1, 1, 1],
    [1, 0, 0, 0, 0, 0, 0, 0, 0, 0, 0, 0, 0, 0, 0, 1],
    [1, 0, 0, 3, 3, 3, 3, 0, 0, 0, 2, 2, 2, 0, 0, 1],
    [1, 0, 0, 0, 0, 0, 4, 0, 0, 0, 0, 0, 2, 0, 0, 1],
    [1, 0, 0, 0, 0, 0, 4, 0, 0, 0, 0, 0, 2, 0, 0, 1],
    [1, 0, 0, 3, 3, 3, 3, 0, 0, 0, 0, 0, 0, 0, 0, 1],
    [1, 0, 0, 0, 0, 0, 0, 0, 0, 0, 0, 0, 0, 0, 0, 1],
    [1, 0, 0, 0, 4, 0, 0, 0, 4, 0, 0, 0, 0, 0, 0, 1],
    [1, 1, 1, 3, 1, 3, 1, 1, 1, 3, 0, 0, 3, 1, 1, 1],
    [1, 1, 1, 1, 1, 1, 1, 1, 1, 3, 0, 0, 3, 1, 1, 1],
    [1, 1, 1, 1, 1, 1, 1, 1, 1, 3, 0, 0, 3, 1, 1, 1],
    [1, 1, 3, 1, 1, 1, 1, 1, 1, 3, 0, 0, 3, 1, 1, 1],
    [1, 4, 0, 0, 0, 0, 0, 0, 0, 0, 0, 0, 0, 0, 0, 1],
    [3, 0, 0, 0, 0, 0, 0, 0, 0, 0, 0, 0, 0, 0, 0, 1],
    [1, 0, 0, 0, 0, 0, 0, 0, 0, 0, 0, 0, 0, 0, 0, 1],
    [1, 0, 0, 2, 0, 0, 0, 0, 0, 3, 4, 0, 4, 3, 0, 1],
    [1, 0, 0, 5, 0, 0, 0, 0, 0, 0, 3, 0, 3, 0, 0, 1],
    [1, 0, 0, 2, 0, 0, 0, 0, 0, 0, 0, 0, 0, 0, 0, 1],
    [1, 0, 0, 0, 0, 0, 0, 0, 0, 0, 0, 0, 0, 0, 0, 1],
    [3, 0, 0, 0, 0, 0, 0, 0, 0, 0, 0, 0, 0, 0, 0, 1],
    [1, 4, 0, 0, 0, 0, 0, 0, 4, 0, 0, 4, 0, 0, 0, 1],
    [1, 1, 3, 3, 0, 0, 3, 3, 1, 3, 3, 1, 3, 1, 1, 1],
    [1, 1, 1, 3, 0, 0, 3, 1, 1, 1, 1, 1, 1, 1, 1, 1],
    [1, 3, 3, 4, 0, 0, 4, 3, 3, 3, 3, 3, 3, 3, 3, 1],
    [3, 0, 0, 0, 0, 0, 0, 0, 0, 0, 0, 0, 0, 0, 0, 3],
    [3, 0, 0, 0, 0, 0, 0, 0, 0, 0, 0, 0, 0, 0, 0, 3],
    [3, 0, 0, 0, 0, 0, 0, 0, 0, 0, 0, 0, 0, 0, 0, 3],
    [3, 0, 0, 5, 0, 0, 0, 5, 0, 0, 0, 5, 0, 0, 0, 3],
    [3, 0, 0, 0, 0, 0, 0, 0, 0, 0, 0, 0, 0, 0, 0, 3],
    [3, 0, 0, 0, 0, 0, 0, 0, 0, 0, 0, 0, 0, 0, 0, 3],
    [3, 0, 0, 0, 0, 0, 0, 0, 0, 0, 0, 0, 0, 0, 0, 3],
    [3, 3, 3, 3, 3, 3, 3, 3, 3, 3, 3, 3, 3, 3, 3, 3]
  ],
  "sprite_map": "sprite_map.json"
}